[ {
                "level": "31",
                "author": "搬运 派大星 QQ:373900742(侵删)",
                "map": [[2,2,2,2,2,2,2,2,0,2,2,2,2,2],
[2,5,5,2,5,5,5,2,2,2,5,5,5,2],
[2,5,5,5,5,5,5,2,2,5,3,5,5,2],
[2,4,2,5,1,5,2,2,5,3,5,5,2,2],
[2,4,2,5,5,5,2,5,3,5,5,2,2,0],
[2,4,2,5,5,5,5,3,5,5,2,2,0,0],
[2,4,5,2,2,5,2,2,2,2,2,0,0,0],
[2,2,5,5,5,5,2,0,0,0,0,0,0,0],
[0,2,2,2,2,2,2,0,0,0,0,0,0,0]]


},
 {
                "level": "32",
                "author": "搬运 派大星 QQ:373900742(侵删)",
                "map": [[2,2,2,2,0,0,0,0,0],
[2,5,5,2,2,2,2,0,0],
[2,5,3,5,5,5,2,0,0],
[2,5,4,2,5,5,2,0,0],
[2,5,3,2,5,2,2,0,0],
[2,5,4,5,5,2,0,0,0],
[2,2,2,2,5,2,0,0,0],
[0,0,0,2,5,2,0,0,0],
[0,2,2,2,5,2,2,2,0],
[0,2,5,5,3,5,5,2,0],
[2,2,5,2,3,2,5,2,2],
[2,5,3,5,1,5,3,5,2],
[2,5,4,4,2,4,4,5,2],
[2,2,2,5,5,5,2,2,2],
[0,0,2,2,2,2,2,0,0]]


},
 {
                "level": "33",
                "author": "搬运 派大星 QQ:373900742(侵删)",
                "map": [[0,0,0,2,2,2,2,0,0,0,0,0],
[0,2,2,2,5,5,2,2,2,2,2,0],
[0,2,5,3,3,5,2,5,5,5,2,0],
[0,2,5,3,5,4,5,4,3,3,2,2],
[0,2,5,4,4,5,2,4,5,3,5,2],
[2,2,2,5,2,6,6,5,4,5,5,2],
[2,5,5,4,5,6,6,2,5,2,2,2],
[2,5,3,5,4,2,5,4,4,5,2,0],
[2,2,3,3,4,1,4,5,3,5,2,0],
[0,2,5,5,5,2,5,3,3,5,2,0],
[0,2,2,2,2,2,5,5,2,2,2,0],
[0,0,0,0,0,2,2,2,2,0,0,0]]


},
 {
                "level": "34",
                "author": "搬运 派大星 QQ:373900742(侵删)",
                "map": [[2,2,2,2,2,2,2,2,2,2,2,0,0,0,0],
[2,5,5,5,5,5,2,5,5,5,5,2,0,0,0],
[2,4,2,2,5,5,2,3,2,2,5,5,2,0,0],
[2,5,5,5,2,5,5,5,5,5,2,5,5,2,0],
[2,3,5,5,2,5,2,2,2,5,5,2,5,5,2],
[2,5,2,5,5,5,5,5,5,2,5,5,2,5,2],
[2,5,2,5,2,2,2,2,5,5,2,5,2,5,2],
[2,4,5,1,5,5,5,5,3,5,6,5,4,5,2],
[2,2,2,2,2,2,2,2,2,2,2,2,2,2,2]]
},
	{
		"level": "35",
		"author": "by 数码宝贝51(QQ1911761593)",
		"map": [[2,2,2,2,2,2,2,2,2,2,2,2,2],
[2,4,4,4,4,4,4,4,4,4,5,4,2],
[2,5,6,3,4,3,5,3,6,3,4,5,2],
[2,5,3,5,5,2,2,2,5,5,3,5,2],
[2,5,6,3,2,2,2,2,2,5,6,5,2],
[2,5,5,5,2,2,4,2,2,5,5,5,2],
[2,5,6,3,2,2,5,2,2,3,6,5,2],
[2,5,3,5,5,2,5,2,5,5,3,5,2],
[2,5,6,3,4,3,4,3,4,3,6,3,2],
[2,5,5,5,5,5,5,5,5,5,5,4,2],
[2,2,2,2,2,2,3,2,2,2,2,2,2],
[2,1,3,5,5,5,5,5,5,5,5,4,2],
[2,2,2,2,2,2,2,2,2,2,2,2,2]]
	},
 {"level":"36","author":"by zhouyw","map":[[2,2,2,2,0,0],[2,5,5,2,2,0],[2,1,4,5,2,0],[2,4,4,3,2,2],[2,5,3,3,5,2],[2,5,5,5,5,2],[2,2,2,2,2,2]]}

]
